16
16
11
192
0	0	0	0	0	0	0	0	0	0	0	0	0	0	0	0	1	2	3	4	0	0	0	0	0	0	0	0	0	0	1	2	3	4	0	0	0	0	0	0	0	0	5	6	0	0	0	0	0	0	0	0	0	0	0	0	0	0	1	2	3	4	0	0	0	0	0	0	0	0	0	0	0	0	5	6	0	0	0	0	0	0	0	0	1	2	3	4	0	0	0	0	0	0	0	0	0	0	1	2	3	4	0	0	0	0	0	0	0	0	0	0	0	0	0	0	0	0	0	0	0	0	0	0	0	0	0	0	1	2	3	4	0	0	0	0	0	0	5	6	0	0	0	0	0	0	0	0	0	0	0	0	0	0	0	0	0	0	0	0	0	0	0	0	0	0	0	0	0	0	0	0	0	0	1	2	3	4	0	0	0	0	0	0	0	0	5	6	0	0	7	8	
0	0	0	0	0	0	0	0	0	0	0	0	0	0	0	0	9	10	11	12	0	0	0	0	0	0	0	0	0	0	9	10	11	12	0	0	0	0	0	0	0	0	13	14	0	0	0	0	0	0	0	0	0	0	0	0	0	0	9	10	11	12	0	0	0	0	0	0	0	0	0	0	0	0	13	14	0	0	0	0	0	0	0	0	9	10	11	12	0	0	0	0	0	0	0	0	0	0	9	10	11	12	0	0	0	0	0	0	0	0	0	0	15	3	0	0	0	0	0	0	0	0	0	0	0	0	0	0	9	10	11	12	0	0	0	0	0	0	13	14	0	0	0	0	0	0	0	0	0	0	15	3	0	0	0	0	0	0	0	0	0	0	0	0	0	0	0	0	0	0	0	0	0	0	9	10	11	12	0	0	0	0	0	0	0	0	13	14	0	0	7	16	
0	0	0	0	0	0	0	0	5	6	0	0	0	0	0	0	0	0	0	0	0	0	5	6	0	0	0	0	0	0	0	0	0	0	0	0	17	18	18	18	18	18	18	18	18	19	0	0	0	0	0	0	0	0	5	6	0	0	0	0	0	0	0	0	0	0	0	0	20	18	18	18	18	19	0	0	17	18	18	18	18	19	0	0	0	0	0	0	0	0	0	0	5	6	0	0	0	0	0	0	17	18	18	18	18	18	18	18	18	19	0	0	1	2	3	4	0	0	20	18	18	19	0	0	0	0	0	0	0	0	0	0	0	0	0	0	0	0	0	0	0	0	0	0	0	0	0	0	0	0	1	2	3	4	0	0	0	0	0	0	0	0	0	0	1	2	3	4	0	0	0	0	0	0	0	0	0	0	0	0	0	0	0	0	0	0	0	0	0	0	7	8	
0	0	15	3	0	0	0	0	13	14	0	0	0	0	0	0	0	0	0	0	0	0	13	14	0	0	0	0	0	0	0	0	0	0	0	0	7	21	21	22	21	22	21	22	21	23	0	0	15	3	0	0	0	0	13	14	0	0	0	0	0	0	0	0	0	0	0	0	24	22	21	22	21	23	0	0	7	21	21	22	21	25	0	0	0	0	0	0	0	0	0	0	13	14	0	0	0	0	0	0	7	21	21	22	21	22	21	22	21	23	0	0	9	10	11	12	0	0	24	22	21	23	0	0	0	0	0	0	0	0	0	0	0	0	0	0	0	0	0	0	0	0	15	3	0	0	0	0	0	0	9	10	11	12	0	0	0	0	0	0	0	0	0	0	9	10	11	12	0	0	0	0	0	0	0	0	0	0	0	0	0	0	15	3	0	0	0	0	0	0	7	16	
0	0	1	2	3	4	0	0	0	0	0	0	0	0	0	0	0	0	0	0	0	0	0	0	0	0	17	18	18	18	18	18	18	18	18	18	26	8	16	8	16	8	16	8	16	25	0	0	1	2	3	4	0	0	0	0	0	0	17	19	0	0	5	6	0	0	27	28	24	8	16	8	16	25	0	0	7	8	16	8	16	25	29	18	18	18	18	18	18	18	18	18	18	18	18	18	18	18	18	18	26	8	16	8	16	8	16	8	16	25	0	0	0	0	0	0	27	28	24	8	16	25	0	0	0	0	0	0	0	0	0	0	0	0	17	18	18	18	18	19	0	0	1	2	3	4	0	0	0	0	0	0	0	0	0	0	0	0	5	6	0	0	0	0	0	0	0	0	0	0	17	18	18	18	18	18	18	18	18	19	0	0	1	2	3	4	0	0	0	0	7	8	
0	0	9	10	11	12	0	0	0	0	0	0	15	3	0	0	0	0	0	0	0	0	0	0	0	0	7	21	21	22	21	22	21	22	21	22	8	16	8	16	8	16	8	16	8	25	0	0	9	10	11	12	0	0	0	0	0	0	7	23	0	0	13	14	0	0	0	0	24	16	8	16	8	25	0	0	7	16	8	16	8	16	21	22	21	22	21	22	21	22	21	22	21	22	21	22	21	22	21	22	8	16	8	16	8	16	8	16	8	25	0	0	0	0	0	0	0	0	24	16	8	25	0	0	0	0	0	0	0	0	0	0	0	0	7	21	21	22	21	23	0	0	9	10	11	12	0	0	0	0	0	0	0	0	0	0	0	0	13	14	0	0	0	0	0	0	0	0	0	0	7	21	21	22	21	22	21	22	21	23	0	0	9	10	11	12	0	0	0	0	30	16	
0	0	0	0	0	0	0	0	0	0	0	0	1	2	3	4	17	18	18	18	18	18	18	18	18	18	26	8	16	8	16	8	16	8	16	8	16	8	16	8	16	8	16	8	16	25	0	0	0	0	0	0	0	0	17	19	0	0	7	25	0	0	0	0	0	0	0	0	24	8	16	8	16	8	0	0	16	8	16	8	31	18	18	32	16	8	16	8	16	8	16	8	31	18	18	32	16	8	16	8	16	8	16	8	16	8	16	8	16	33	13	14	34	35	13	14	13	14	24	8	16	25	13	14	17	19	34	35	17	18	18	18	18	18	26	8	16	8	16	25	0	0	0	0	0	0	17	18	18	19	0	0	0	0	0	0	17	18	18	18	18	19	0	0	0	0	17	18	18	18	26	8	16	8	16	8	16	8	16	25	0	0	0	0	0	0	0	0	0	0	36	7	
0	0	0	0	0	0	0	0	0	0	0	0	9	10	11	12	7	21	21	22	21	22	21	22	21	22	8	16	8	16	8	16	8	16	8	16	8	16	8	16	8	16	8	16	8	25	0	0	0	0	0	0	0	0	7	23	0	0	7	25	0	0	0	0	0	0	0	0	37	16	8	16	8	16	0	0	8	16	8	16	38	39	39	39	8	16	8	16	8	16	8	16	38	39	39	39	8	16	8	16	8	16	8	16	8	16	8	16	40	41	41	41	42	43	41	41	41	41	24	16	8	25	41	41	7	23	42	43	7	21	21	22	21	22	8	16	8	16	8	25	0	0	0	0	0	0	7	21	21	25	0	0	0	0	0	0	7	21	21	22	21	25	0	0	0	0	7	21	21	22	8	16	8	16	8	16	8	16	8	25	0	0	0	0	0	0	0	0	0	0	36	7	
18	18	18	18	18	18	18	18	18	18	18	18	18	18	18	18	26	8	16	8	16	8	16	8	16	8	16	8	16	8	16	8	16	8	16	8	16	8	16	8	16	8	16	8	16	25	34	35	13	14	17	19	13	14	7	25	13	14	7	8	29	18	18	18	18	18	18	18	26	8	16	8	31	18	18	18	18	32	16	8	16	8	16	8	16	8	31	18	18	32	16	8	16	8	16	8	16	8	31	18	18	18	18	18	18	32	16	25	44	45	44	45	44	45	17	19	44	45	24	8	16	25	44	45	7	25	44	45	7	8	16	8	16	8	16	8	16	8	16	25	29	18	18	18	18	18	26	8	16	25	29	18	18	18	18	18	26	8	16	8	16	25	29	18	18	18	26	8	16	8	16	8	16	8	16	8	16	8	16	25	34	35	13	14	17	18	18	18	18	18	46	7	
21	22	21	22	21	22	21	22	21	22	21	22	21	22	21	22	8	16	8	16	8	16	8	16	8	16	8	16	8	16	8	16	8	16	8	16	8	16	8	16	8	16	8	16	8	25	42	43	41	41	7	23	41	41	7	25	41	41	7	16	21	22	21	22	21	22	21	22	8	16	8	16	38	39	39	39	39	39	8	16	8	16	8	16	8	16	38	39	39	39	8	16	8	16	8	16	8	16	38	39	39	39	39	39	39	39	8	25	47	47	47	47	47	47	7	23	47	47	37	16	8	25	47	47	7	25	47	47	7	16	8	16	8	16	8	16	8	16	8	16	21	22	21	22	21	22	8	16	8	16	21	22	21	22	21	22	8	16	8	16	8	16	21	22	21	22	8	16	8	16	8	16	8	16	8	16	8	16	8	25	42	43	41	41	7	21	21	22	21	22	39	16	
16	8	16	8	16	8	16	8	16	8	16	8	16	8	16	8	16	8	16	8	16	8	16	8	16	8	16	8	16	8	16	8	16	8	16	8	16	8	16	8	16	8	16	8	16	25	44	45	44	45	7	25	44	45	7	25	44	45	7	8	16	8	16	8	16	8	16	8	16	8	16	8	16	8	16	8	16	8	16	8	16	8	16	8	16	8	16	8	16	8	16	8	16	8	16	8	16	8	16	8	16	8	16	8	16	8	16	25	48	48	48	48	48	48	7	25	48	48	7	8	16	25	48	48	7	25	48	48	7	8	16	8	16	8	16	8	16	8	16	8	16	8	16	8	16	8	16	8	16	8	16	8	16	8	16	8	16	8	16	8	16	8	16	8	16	8	16	8	16	8	16	8	16	8	16	8	16	8	16	25	44	45	44	45	7	8	16	8	16	8	16	8	
